Under the Boardwalk - The Drifters
You can close your eyes - James Taylor
I'm still standing - Elton John
Home - Philip Philips
We are young - Fun
Piano man- Billy Joel
Africa- TOTO
Home - Edward Sharpe & The Magnetic Zeros
Little Talks - Of Monsters and Men
I'm Yours - Jason Mraz
Don't Stop Believin' - Journey
Stay - Rihanna
Killer Queen - Queen
Heart of glass or One way or another. - Blondie
Ironic - Alannis Morissette
Believe - Cher
I feel the earth move - Carol King
Heart Of Glass - Blondie *****
One Way Or Another - Blondie
You're so vain - Carly Simon
Ready - Alessia Cara
American Boy - Estelle, Kanye West***
Killing Me Softly With This Song - Fugees, Lauryn Hill*
Fingers Crossed - Lauren Spencer Smitch
You oughta Know - Alanis Morissette
The Best Of Both Worlds - Hannah Montana
Man! I feel like a Women - Shania Twain**
Sweet Dreams - Ari Lennox, Eurythmics, *****
Cherry-coloured Funk - Cocteau Twins
Skyfall- Adele**
Take A Chance On Me - ABBA***
Mamma Mia - ABBA****
Somethin' Bad - Miranda Lambert & Carrie Underwood
Does Your Mother Know - ABBA
Slipping Through My Fingers - ABBA*
Stay, stay, stay - Taylor Swift*
Edge of Seventeen - Stevie Nicks ***
A Thousand Years - Christina Perri
I Think We're Alone Now - Tiffany
Me and Bobby McGee - Janis Joplin****
Fly - Nicki Minaj, Rihanna
I'm With You - Avril Lavigne
Ironic - Alanis Morisette
Kids in America - Kim Wilde
Wanted You More - Lady Antebellum
My Immortal - Evanscence
Back To Black - Amy Winehouse
Zombie- The Cranberries
Jolene - Dolly Parton
Bette Davis Eyes - Kim Carnes
Holding Out For A Hero - Bonnie Tyler
If I Die Young - The Band Perry
Don't Wanna Fight - Alabama Shakes
Please Mr Postman - The Carpenter
Dog Days Are Over - Florence and the Machine
Bring Me to Life - Evanescence
Will You Still Love Me Tomorrow - The Shirelles
Motion Sickness - Phoebes Bridge
Everytime We Touch - Cascada
On My Own - Samantha Barks
The vamps - somebody to you*******
Beautiful girls - sean kingston*
Party Rock - LMFAO *
Home - Edward Sharpe & The Magnetic Zeros****
Tongue Tied - Grouplove *
Saturday Sun - Vance Joy *
My Girl - The Temptations **********
Uptown Girl- Billy joel **********
Land Down Under - Men at Work***
Safe and Sound - Capital Cities **********
Logical song - Supertramp *******
Losing my Religion- REM *****
Mess is Mine - Vance Joy *
You can call me Al - Paul Simon
Fell in Love with a Girl - White Stripes
Dog Days are Over - Florence + The Machine *
I'm Yours - Jason Mraz 
Freaks - Surf Curse*******
Got my mind set on you - George Harrison**
Best Friend - Rex Orange Country******
Young Folks - Peter Bjorn and John**
Cleopatra- the Lumineers**
St. James Infirmary - Cab Calloway
Somebody to Love - Jefferson Airplane
Lie - Sasha Alex Sloan *
American Pie - Don McLean*********
Footloose- Kenny Loggins ******
Summer of 69- Bryan Adams**************
Eye of the Tiger - Survivor *********
Act Naturally - Beatles or Buck Owens
Homeward bound - simon and garfunkel ***
Anything - Hedley**
Let her dance - Bobby Fuller Four
Dust in the wind - kansas**
Sign of the gypsy queen - april wine*
What once was - her's*
The Man Who Sold The World - Nirvana (Version)*******
Story Of my Life - One Direction*******
Missing Piece - Vance Joy*
If I could Fly- One Direction****
El Condor Pasa - Simon & Garfunkel
Colder Weather- Zac Brown Band***
Cloud Number nine- Bryan Adams
Accidentally in Love - Counting Crows*****
Show me your genital- Jon Lajoie**
Gives You Hell - The All-American Rejects
Daydream Believer - Monkees **
Fool's Gold - One Direction******
White Blank Page - Mumford & Sons
Play that Song- Train********
Humility - Gorillaz****
Only When I dream - Bobby Fuller Four
Nights in White Satin - Moody Blues
Time in a Bottle - Jim Croce
Somewhere only we know- Keane **
Starting Over- Chris Stapleton
Some night - fun******
She Loves You - The Beatles*
C'mon c'mon- one direction*******
Twist And Shout - The Beatles*******
Happily - One Direction**
Mr. Tambourine Man - The Byrds
Elenor Rigby - The Beatles
My Kinda Woman - Mac DeMarco**
Sweet home Alabama- Lynyrd Skynyrd*******
Amnesia - 5SOS*
Iris - The Goo Goo Dolls***
Happy Day
Wake Me Up Before You Go-Go - Wham!******
How To Save A Life - The Fray
Strong - One Direction*****
Pompeii- Bastille*******
Best Day Of My Life- American Authors***
Tonight I Fell in Love - Tokens
Time is running out - Muse**
Jessie's Girl - Rick Springfield******
Counting stars - OneRepublic *
Somebody that I used to know - Gotye****
Bad to the bone - George Thorogood and the destroyers*****
Another one bites the dust - Queen*******
Ain't no rest for the wicked - Cage the elephant*
Highway to hell - AC/DC***
Saturday night's alright - Elton John****
Locked out of heaven - Bruno Mars*****
September - Earth Wind and Fire*********
Let's groove - Earth Wind and Fire**
Radio GaGa - Queen*****
Killer Queen - Queen********
Rocket Man - Elton John**********
Tiny Dancer- Elton John***********
The Joker - Steve Miller Band
Start me up - The Rolling Stones***
Johnny B Goode - Chuck Berry*******
You really got me - Van Halen**
Have you even seen the rain - Creedance Clearwater Revival**
Bad Moon Rising - Creedance Clearwater Revival
Should I stay or should I go - The Clash******
Take me home, Country Roads - John Denver******
Don't stop 'til you get enough - Michael Jackson****
Wanna be starting something - Michael Jackson*
Dirty Diana - Michael Jackson*
They don't care about us - Michael Jackson
Earth song - Michael Jackson
Off the wall - Michael Jackson*
On melancholy Hill - Gorillaz****
Do I Wanna Know - Arctic Monkeys****
Sweet Child O Mine - Guns n Roses ********
Band on the Run - Paul McCartney & Wings*
Somebody to Love - Queen ********
You Make My Dreams (Come True) - Daryl Hall & John Oates*****
Drive My Car - The Beatles******
Hotel California - Eagles *********
Rebel Rebel - David Bowie******
Turn, Turn, Turn - The Byrds
Land of Confusion - Genesis*
Feeling Good- Michael Bublï¿½*****
Californication- Red Hot Chili Pepper*****
Ghost town - benson boone
Eenie Meenie - Sean Kingston, Justin Bieber
Dynamite - Taio Cruz******
Sea, Swallow Me - Cocteau Twins
Drive - The Cars
American Boy - Estelle, Kanye West
Carry on my Wayward Son - Kansas**
Sex on Fire - Kings of Leon***
Hey Ya! - Outkast*****
Ms.Jackson - Outkast*
Losing My Religion - REM******
505 - Arctic Monkeys****
Tainted Love - Soft Cell****
Surfing  usa- The beach boys******
Let's Groove - Earth Wind and Fire*
Sledgehammer - Peter Gabriel
Freedom - Wham!
Tonight, Tonight, Tonight - Genesis
Invisible Touch - Genesis
Wonderwall - Oasis****
Heaven -Bryan Adams*
boulevard of broken dreams -Green day*
Ring of fire -Johnny Cash**
Yesterday-The Beatles*******
Creep - Radiohead**
Twist and shout - The Beatles
Enjoy the Silence - Depeche Mode\
Friday I'm In Love - The Cure
Ain't No Mountain High Enough - Marvin Gaye, Tammi Terrell********
You Give Love a Bad Name - Bon Jovi*******
Sweet Caroline- Neil Diamond *******
Step by step - new kids on the block
Hey Jude - The Beatles****
American Idiot- Green Day*****
Radio - Rammstien*
Schism - tool
All Star- Smash Mouth*********
It's still rock n roll to me -  Billy Joel******
Only the good die young - Billy Joel*****
Wherever I may roam - metallica 
Home depot theme song ***************************** that's a banger
I'm a believer- Smash Mouth******
B.Y.O.B - System of a down*
House of the rising sun********
Big time rush - big time rush
Just the two of us- Bill Withers
Shape of you - Ed Sheeran
SOB - Nathaniel Rateliff & The Night Sweats*****
Live and let die - Gun's and Roses*****
Sick love - red hot chili pepper****
Hey There Delilah - Plain White T's****
Betrayal - Pain
Boom Boom Pow -BEP****
Vienna - Billy Joel****
Paradise by the Dashboard Light - Meat Loaf